#########
#.......#
#.....@.#
#.P.*.O.#
#.......#
#.......#
#########
;
#####
#P*.#
#####
